border_size=1
usage=map

Wo          , Wo          , Wo          , Wo          , Wo          , Wo          , Wo          , Wo          , Wo          , Wo          , Wo          , Wo          , Wo          , Wo          , Wo          , Wo          , Wo          , Wo          , Wo          , Wo          , Wo          , Wo          , Wo          , Wo          , Wo          , Wo          , Wo          , Wo          , Wo          , Wo          , Wo          , Wo          , Wo          , Wo          , Wo          , Wo          , Wo          , Wo          , Wo          , Wo          , Wo          , Wo          , Wo          , Wo          , Wo          , Wo          , Wo          , Wo          
Wo          , Wo          , Wo          , Wo          , Wo          , Wo          , Wo          , Wo          , Wo          , Wo          , Wo          , Wo          , Wo          , Wo          , Wo          , Wo          , Wo          , Wo          , Wo          , Wo          , Wo          , Wo          , Wo          , Wo          , Wo          , Wo          , Wo          , Wo          , Wo          , Wo          , Wo          , Wo          , Wo          , Wo          , Wo          , Wo          , Wo          , Wo          , Wo          , Wo          , Wo          , Wo          , Wo          , Wo          , Wo          , Wo          , Wo          , Wo          
Wo          , Wo          , Wo          , Wo          , Wo          , Wo          , Wo          , Wo          , Wo          , Wo          , Wo          , Wo          , Wo          , Wo          , Wo          , Wo          , Wo          , Wo          , Wo          , Wo          , Wo          , Wo          , Wo          , Wo          , Wo          , Wo          , Wo          , Wo          , Wo          , Wo          , Wo          , Wo          , Wo          , Wo          , Wo          , Wo          , Wo          , Wo          , Wo          , Wo          , Wo          , Wo          , Wo          , Wo          , Wo          , Wo          , Wo          , Wo          
Wo          , Wo          , Wo          , Wo          , Wo          , Wo          , Wo          , Wo          , Wo          , Wo          , Wo          , Wo          , Wo          , Wo          , Wo          , Wo          , Wo          , Wo          , Wo          , Wo          , Wo          , Wo          , Wo          , Wo          , Wo          , Wo          , Wo          , Wo          , Wo          , Wo          , Wo          , Wo          , Wo          , Wo          , Wo          , Wo          , Wo          , Wo          , Wo          , Wo          , Wo          , Wo          , Wo          , Wo          , Wo          , Wo          , Wo          , Wo          
Wo          , Wo          , Wo          , Wo          , Wo          , Wo          , Wo          , Wo          , Wo          , Wo          , Wo          , Wo          , Wo          , Wo          , Wo          , Wo          , Wo          , Wo          , Wo          , Wo          , Wo          , Wo          , Wo          , Wo          , Wo          , Wo          , Wo          , Wo          , Wo          , Wo          , Wo          , Wo          , Wo          , Wo          , Wo          , Wo          , Wo          , Wo          , Wo          , Wo          , Wo          , Wo          , Wo          , Wo          , Wo          , Wo          , Wo          , Wo          
Wo          , Wo          , Wo          , Wo          , Wo          , Wo          , Wo          , Wo          , Wo          , Wo          , Wo          , Wo          , Wo          , Wo          , Wo          , Wo          , Wo          , Wo          , Wo          , Wo          , Wo          , Wo          , Wo          , Wo          , Wo          , Wo          , Wo          , Wo          , Wo          , Wo          , Wo          , Wo          , Wo          , Wo          , Wo          , Wo          , Wo          , Wo          , Wo          , Wo          , Wo          , Wo          , Wo          , Wo          , Wo          , Wo          , Wo          , Wo          
Wo          , Wo          , Wo          , Wo          , Wo          , Wo          , Wo          , Wo          , Wo          , Wo          , Wo          , Wo          , Wo          , Wo          , Wo          , Wo          , Wo          , Wo          , Wo          , Wo          , Wo          , Wo          , Wo          , Wo          , Wo          , Wo          , Wo          , Wo          , Wo          , Wo          , Wo          , Wo          , Wo          , Wo          , Wo          , Wo          , Wo          , Wo          , Wo          , Wo          , Wo          , Wo          , Wo          , Wo          , Wo          , Wo          , Wo          , Wo          
Wo          , Wo          , Wo          , Wo          , Wo          , Wo          , Wo          , Wo          , Wo          , Wo          , Wo          , Wo          , Wo          , Wo          , Wo          , Wo          , Wo          , Wo          , Wo          , Wo          , Wo          , Wo          , Wo          , Wo          , Wo          , Wo          , Wo          , Wo          , Wo          , Wo          , Wo          , Wo          , Wo          , Wo          , Wo          , Wo          , Wo          , Wo          , Wo          , Wo          , Wo          , Wo          , Wo          , Wo          , Wo          , Wo          , Wo          , Wo          
Wo          , Wo          , Wo          , Wo          , Wo          , Wo          , Wo          , Wo          , Wo          , Wo          , Wo          , Wo          , Wo          , Wo          , Wo          , Wo          , Wo          , Wo          , Wo          , Wo          , Wo          , Wo          , Wo          , Wo          , Wo          , Wo          , Wo          , Wo          , Wo          , Wo          , Wo          , Wo          , Wo          , Wo          , Wo          , Wo          , Wo          , Wo          , Wo          , Wo          , Wo          , Wo          , Wo          , Wo          , Wo          , Wo          , Wo          , Wo          
Wo          , Wo          , Wo          , Wo          , Wo          , Wo          , Wo          , Wo          , Wo          , Wo          , Wo          , Wo          , Wo          , Wo          , Wo          , Wo          , Wo          , Wo          , Wo          , Wo          , Wo          , Wo          , Wo          , Wo          , Wo^Bw|      , Wo          , Wwr         , Wo          , Wo^Bw|      , Wo          , Wo          , Wo          , Wo          , Wo          , Wo          , Wo          , Wo          , Wo          , Wo          , Wo          , Wo          , Wo          , Wo          , Wo          , Wo          , Wo          , Wo          , Wo          
Wo          , Wo          , Wo          , Wo          , Wo          , Wo          , Wo          , Wo          , Wo          , Wo          , Wo          , Wo          , Wo          , Wo          , Wo          , Wo          , Wo          , Wo          , Wo          , Wo          , Wo          , Wwr         , Wwr         , Wo          , Ww^Bw|      , Ww          , Ww          , Ww          , Ww^Bw|      , Wo          , Ww          , Ww          , Wwr         , Wo          , Ww          , Wo          , Wo          , Wo          , Wo          , Wo          , Wo          , Wo          , Wo          , Wo          , Wo          , Wo          , Wo          , Wo          
Wo          , Wo          , Wo          , Wo          , Wo          , Wo          , Wo          , Wo          , Wo          , Wo          , Wo          , Wo          , Wo          , Wo          , Wo          , Wo          , Wo          , Wo          , Wo          , Wo          , Ww          , Wwr         , Ww          , Ww          , Ww^Bw|      , Ww          , Ww          , Ww          , Ww^Bw|      , Ww          , Ww          , Wwr         , Wwr         , Ww          , Ww          , Ww          , Wo^Bw/      , Wo          , Wo          , Wo          , Wo          , Wo          , Wo          , Wo          , Wo          , Wo          , Wo          , Wo          
Wo          , Wo          , Wo          , Wo          , Wo          , Wo          , Wo          , Wo          , Wo          , Wo          , Wo          , Wo          , Wo          , Wo          , Wo          , Wo          , Wo          , Wo          , Wo          , Wo^Bw\      , Ww^Bw\      , Ww          , Ww          , Ww          , Rd          , Ww          , Gs          , Ww          , Rd          , Ww          , Ww          , Ww          , Ww          , Ww          , Ww^Bw/      , Ww^Bw/      , Ww          , Wo          , Wo          , Wo          , Wo          , Wo          , Wo          , Wo          , Wo          , Wo          , Wo          , Wo          
Wo          , Wo          , Wo          , Wo          , Wo          , Wo          , Wo          , Wo          , Wo          , Wo          , Wo          , Wo          , Wo          , Wo          , Wo          , Wo          , Wo          , Wo          , Wwr         , Ww          , Ww          , Ww^Bw\      , Rd          , Rd          , Gs^Ft       , Gs          , Gg          , Gs          , Rd          , Gs^Ft       , Rr^Vd       , Gs          , Rd          , Ww^Bw/      , Ww          , Ww          , Wwr         , Wwr         , Wo          , Wo          , Wo          , Wo          , Wo          , Wo          , Wo          , Wo          , Wo          , Wo          
Wo          , Wo          , Wo          , Wo          , Wo          , Wo          , Wo          , Wo          , Wo          , Wo          , Wo          , Wo          , Wo          , Wo          , Wo          , Wo          , Wo          , Wo          , Wwr         , Wwr         , Ww          , Ww          , Gs          , Rd          , Rr^Vd       , Gg          , Gg          , Gs          , Rd          , Gg          , Gg          , Rd          , Gs          , Ww          , Ww          , Ww          , Ww          , Wwr         , Wo          , Wo          , Wo          , Wo          , Wo          , Wo          , Wo          , Wo          , Wo          , Wo          
Wo          , Wo          , Wo          , Wo          , Wo          , Wo          , Wo          , Wo          , Wo          , Wo          , Wo          , Wo          , Wo          , Wo          , Wo          , Wo          , Wo          , Wo          , Ww          , Ww          , Ww          , Kh          , Gg          , Rd          , Rd          , Gs          , Rd          , Gs^Ft       , Rd          , Gs          , Rd          , Rd          , Gs          , Kh          , Gs^Ft       , Ww          , Ww^Bw/      , Wo^Bw/      , Wo          , Wo          , Wo          , Wo          , Wo          , Wo          , Wo          , Wo          , Wo          , Wo          
Wo          , Wo          , Wo          , Wo          , Wo          , Wo          , Wo          , Wo          , Wo          , Wo          , Wo          , Wo          , Wo          , Wo          , Wo          , Wo          , Wo^Bw\      , Ww          , Ww          , Ww          , Gs^Ft       , Gs^Ft       , Gg          , Gs          , Gs          , Rd          , Ch          , Rd          , Ch          , Rd          , Rd          , Rr^Vd       , Rd          , Rd          , Rd          , Ww^Bw/      , Ww          , Ww          , Ww          , Wo          , Wo          , Wo          , Wo          , Wo          , Wo          , Wo          , Wo          , Wo          
Wo          , Wo          , Wo          , Wo          , Wo          , Wo          , Wo          , Wo          , Wo          , Wo          , Wo          , Wo          , Wo          , Wo          , Wo          , Wo          , Ww          , Ww^Bw\      , Ww^Bw\      , Ww          , Gs          , Gs^Ft       , Gs          , Rr^Vd       , Gg          , Gg          , Ch          , 1 Kh        , Ch          , Gg          , Hd          , Rd          , Gg          , Gs          , Ww          , Wwr         , Wwr         , Ww          , Ww          , Wo          , Wo          , Wo          , Wo          , Wo          , Wo          , Wo          , Wo          , Wo          
Wo          , Wo          , Wo          , Wo          , Wo          , Wo          , Wo          , Wo          , Wo          , Wo          , Wo          , Wo          , Wo          , Wo          , Wo          , Wo          , Ww          , Ww          , Ww          , Gs          , Dd          , Ds          , Ds          , Ds          , Dd          , Gs^Ft       , Gs          , Ch          , Ds          , Gs          , Hd          , Hd          , Gs^Ft       , Gg          , Ww          , Wwr         , Wwr         , Ww          , Ww          , Wo          , Wo          , Wo          , Wo          , Wo          , Wo          , Wo          , Wo          , Wo          
Wo          , Wo          , Wo          , Wo          , Wo          , Wo          , Wo          , Wo          , Wo          , Wo          , Wo          , Wo          , Wo          , Wo          , Wo          , Wwr         , Wwr         , Ww          , Kh          , Gs          , Dd          , Dd          , Rd          , Rd          , Rd          , Rr^Vd       , Rd          , Rd          , Rd          , Rd          , Rd          , Ds          , Ds          , Ds          , Gs^Ft       , Ww          , Ww          , Wwr         , Ww          , Wo          , Wo          , Wo          , Wo          , Wo          , Wo          , Wo          , Wo          , Wo          
Wo          , Wo          , Wo          , Wo          , Wo          , Wo          , Wo          , Wo          , Wo          , Wo          , Wo          , Wo          , Wo          , Wo          , Ww          , Wwr         , Ww          , Ww          , Gs          , Ds          , Rd          , Rd          , Gs^Fds      , Dd          , Ds          , Rd          , Dd          , Gg          , Gs^Fds      , Gs          , Ds          , Rd          , Gs          , Dd          , Kh          , Ww          , Ww          , Ww          , Ww^Bw/      , Wo^Bw/      , Wo          , Wo          , Wo          , Wo          , Wo          , Wo          , Wo          , Wo          
Wo          , Wo          , Wo          , Wo          , Wo          , Wo          , Wo          , Wo          , Wo          , Wo          , Wo          , Wo          , Wo          , Ww^Bw\      , Ww^Bw\      , Ww          , Ww          , Gs^Ft       , Ds          , Ds          , Rd          , Dd          , Gs^Ft       , Gs^Fds      , Gs^Ft       , Hd          , Gs^Ft       , Gs          , Gs^Fds      , Gs^Fds      , Dd          , Rd          , Rd          , Hd          , Gs          , Ww          , Ww^Bw/      , Ww^Bw/      , Wo          , Wo          , Wo          , Wo          , Wo          , Wo          , Wo          , Wo          , Wo          , Wo          
Wo          , Wo          , Wo          , Wo          , Wo          , Wo          , Wo          , Wo          , Wo          , Wo          , Wo          , Wo          , Wo          , Ww          , Ww          , Ww^Bw\      , Gs          , Gs          , Dd          , Dd          , Rd          , Gs^Ft       , Gs^Fds      , Gs^Fds      , Wwr         , Wwr         , Ww          , Ww          , Ww          , Wwr         , Gs          , Rr^Vd       , Dd          , Rd          , Rd          , Gs          , Ww          , Ww          , Ww          , Wo          , Wo          , Wo          , Wo          , Wo          , Wo          , Wo          , Wo          , Wo          
Wo          , Wo          , Wo          , Wo          , Wo          , Wo          , Wo          , Wo          , Wo          , Wo          , Wwr         , Wo          , Ww          , Ww          , Ww          , Ww          , Gs          , Gs          , Dd          , Rd          , Dd          , Rr^Vd       , Gs^Ft       , Gs          , Ww          , Ww          , Ww          , Wo          , Wo          , Ww          , Ww          , Wwf         , Gs^Ft       , Hd          , Rd          , Gs^Ft       , Ww          , Ww          , Ww          , Wo          , Wo          , Wo          , Wo          , Wo          , Wo          , Wo          , Wo          , Wo          
Wo          , Wo          , Wo          , Wo          , Wo          , Wo          , Wo          , Wo          , Wo          , Wo          , Wwr         , Wwr         , Ww          , Ww          , Ww          , Gs^Ft       , Gs^Ft       , Dd          , Ds          , Rd          , Ds          , Dd          , Gs          , Ww          , Ww          , Wo          , Wo          , Wo          , Wo          , Ww          , Wo          , Ww          , Wwr         , Rd          , Rr^Vd       , Gs          , Gs          , Ww          , Ww          , Ww          , Ww          , Wo          , Wo          , Wo          , Wo          , Wo          , Wo          , Wo          
Wo          , Wo          , Wo          , Wo          , Wwr         , Wo          , Wo          , Wo          , Wo          , Wwr         , Wwr         , Ww          , Ww          , Ww          , Gs          , Gs^Ft       , Rr^Vd       , Dd          , Rd          , Rd          , Hd          , Ds          , Gs          , Ww          , Ww          , Wo          , Wo          , Wo          , Wo          , Wo          , Wo          , Ww          , Gs^Ft       , Rd          , Rd          , Dd          , Gs          , Gs          , Ww          , Ww          , Ww          , Wwr         , Wwr         , Wo          , Wwr         , Wo          , Wo          , Wo          
Ww          , Wo          , Ww          , Wwr         , Ww          , Wwr         , Ww          , Wo          , Ww          , Ww          , Ww          , Ww          , Ww          , Ww          , Gs          , Hd          , Hd          , Dd          , Rd          , Hd          , Hd          , Dd          , Gs^Fds      , Gs          , Wwr         , Wo          , Ww          , Ww          , Ww          , Wo          , Ww          , Ww          , Gs          , Dd          , Rd          , Dd          , Rr^Vd       , Gs^Ft       , Gs^Ft       , Ww          , Ww          , Wwr         , Ww          , Wwr         , Ww          , Ww          , Ww          , Ww          
Ww          , Ww          , Ww          , Ww          , Ww          , Ww          , Ww          , Ww          , Ww          , Ww          , Ww          , Ww          , Ww          , Kh          , Gs          , Hd          , Dd          , Ds          , Dd          , Rd          , Rd          , Dd          , Dd          , Hd          , Gs^Fds      , Wwf         , Gs          , Wwr         , Gs          , Wwf         , Wwr         , Gs          , Gs^Fds      , Dd          , Rd          , Gs          , Dd          , Gs^Ft       , Gs          , Kh          , Ww          , Ww          , Ww          , Ww          , Ww          , Ww          , Ww          , Ww          
Ww          , Ww          , Ww          , Ww          , Ww          , Ww          , Ww          , Ww          , Gs          , Ww          , Gs^Ft       , Ww          , Gs          , Gs          , Dd          , Ch          , Dd          , Dd          , Dd          , Ds          , Rd          , Ds          , Rr^Vd       , Dd          , Gs^Fds      , Gs^Ft       , Dd          , Hd          , Ds          , Gs^Fds      , Gs          , Dd          , Dd          , Rd          , Ds          , Dd          , Dd          , Ch          , Dd          , Gs          , Gs          , Ww          , Gs          , Ww          , Gs          , Ww          , Gs^Ft       , Ww          
Gs          , Gs          , Gs          , Gs          , Gs          , Gs          , Gs^Ft       , Gs          , Dd          , Gs          , Dd          , Gs          , Dd          , Dd          , Dd          , Dd          , Dd          , Ch          , Dd          , Dd          , Gs          , Rd          , Rd          , Dd          , Rd          , Dd          , Rd          , Dd          , Rd          , Rd          , Rd          , Rd          , Rd          , Rd          , Dd          , Ch          , Dd          , Dd          , Dd          , Dd          , Dd          , Gs^Ft       , Dd          , Gs          , Dd          , Gs^Ft       , Gs^Ft       , Gs^Ft       
Gs^Ft       , Gs          , Dd          , Gs^Ft       , Dd          , Dd          , Gs^Ft       , Gs^Ft       , Dd          , Dd          , Dd          , Dd          , Gs          , Dd          , Dd          , Dd          , Dd          , Dd          , Dd          , Ch          , Dd          , Dd          , Dd          , Rd          , Kh          , Rd          , Rd          , Rd          , Kh          , Dd          , Dd          , Dd          , Dd          , Ch          , Dd          , Dd          , Gs^Ft       , Dd          , Gs          , Dd          , Dd^Vdt      , Dd          , Dd          , Dd          , Dd          , Dd          , Dd          , Gs^Ft       
Dd          , Dd          , Dd          , Dd          , Dd          , Dd          , Dd          , Dd          , Dd          , Dd          , Dd^Vdt      , Dd          , Hd          , Hd          , Md          , Md          , Gs          , Dd          , Dd          , Gs          , Dd          , Ch          , Dd          , Ch          , Ch          , Rd          , Rd          , Rd          , Ch          , Ch          , Dd          , Ch          , Dd          , Dd          , Gs          , Dd          , Dd          , Dd          , Dd          , Dd          , Dd          , Dd          , Dd          , Dd          , Dd          , Dd          , Dd          , Dd          
Dd          , Dd          , Dd          , Dd          , Dd          , Dd          , Dd          , Dd          , Dd          , Dd          , Dd          , Hd          , Hd          , Hd          , Md          , Md          , Gs          , Dd          , Dd          , Dd          , Dd          , Dd          , Dd^Vdt      , Dd          , Gs          , Rd          , Rd          , Rd          , Dd          , Dd          , Dd          , Dd^Vdt      , Md          , Dd          , Dd          , Dd          , Dd          , Hd          , Dd          , Md          , Dd          , Dd          , Dd          , Dd          , Dd          , Gs^Ft       , Dd          , Dd          
Dd          , Dd          , Dd          , Hd          , Dd          , Dd          , Gs^Ft       , Dd          , Gs^Ft       , Hd          , Dd          , Hd          , Dd          , Dd          , Dd          , Md          , Gs^Ft       , Hd          , Hd          , Hd          , Gs          , Dd          , Dd          , Dd          , Gs          , Gs          , Rd          , Rd          , Gs          , Dd          , Hd          , Dd          , Dd          , Dd          , Dd          , Dd          , Gs          , Gs          , Dd          , Dd          , Hd          , Gs          , Hd          , Hd          , Dd          , Dd          , Dd          , Dd          
Dd          , Dd          , Dd          , Dd          , Dd          , Hd          , Dd          , Dd          , Dd          , Dd          , Md          , Dd          , Dd          , Gs          , Dd          , Dd          , Dd          , Hd          , Md          , Md          , Hd          , Dd          , Dd          , Dd          , Dd          , Dd          , Rd          , Rd          , Rd          , Dd          , Dd          , Dd          , Dd          , Dd          , Hd          , Dd          , Dd          , Gs^Ft       , Dd          , Gs          , Hd          , Hd          , Md          , Hd          , Dd          , Dd          , Dd          , Dd          
Dd          , Dd          , Dd          , Gs^Ft       , Dd          , Dd          , Dd          , Dd          , Dd          , Gs          , Dd          , Dd          , Hd          , Dd          , Dd          , Dd          , Dd          , Dd          , Dd          , Md          , Hd          , Dd          , Dd          , Dd          , Dd          , Dd          , Dd          , Rd          , Rd          , Dd          , Dd          , Dd          , Dd          , Dd          , Hd          , Hd          , Dd          , Dd          , Hd          , Hd          , Hd          , Md          , Md          , Hd          , Dd          , Dd          , Dd          , Dd          
Dd          , Dd          , Dd          , Dd          , Dd          , Re^Vct      , Ce          , Hd          , Re^Vct      , Dd          , Gs^Ft       , Dd          , Gs          , Dd          , Dd          , Gs          , Dd          , Dd          , Dd          , Dd          , Dd          , Dd          , Dd          , Dd          , Dd          , Dd          , Dd          , Gs          , Rd          , Rd          , Rd          , Dd          , Dd          , Dd          , Dd          , Dd          , Dd          , Dd          , Md          , Hd          , Gs          , Re^Vct      , Ce          , Re          , Re          , Re^Vct      , Dd          , Dd          
Dd          , Dd          , Dd          , Dd          , Dd          , Ce          , 2 Ke        , Ce          , Dd          , Dd          , Dd          , Dd          , Hd          , Dd          , Dd          , Dd          , Dd          , Dd          , Dd          , Dd          , Dd          , Dd          , Dd          , Dd          , Dd          , Dd          , Dd          , Dd          , Dd          , Rd          , Rd          , Dd          , Dd          , Dd          , Dd          , Dd          , Dd          , Dd          , Dd          , Dd          , Re          , Ce          , 3 Ke        , Ce          , Dd          , Dd          , Md          , Dd          
Dd          , Dd          , Hd          , Dd          , Dd          , Re^Vct      , Ce          , Ce          , Dd          , Re^Vct      , Md          , Hd          , Hd          , Dd          , Dd          , Dd          , Dd          , Dd          , Dd          , Dd          , Dd          , Dd          , Dd          , Dd          , Hd          , Dd          , Dd          , Dd          , Dd          , Dd          , Rd          , Rd          , Rd          , Rd          , Rd          , Dd          , Dd          , Dd          , Dd          , Dd          , Re^Vct      , Ce          , Ce          , Ce          , Re          , Dd          , Dd          , Dd          
Dd          , Dd          , Dd          , Dd          , Dd          , Dd          , Re^Vct      , Dd          , Hd          , Dd          , Dd          , Dd          , Dd          , Dd          , Dd          , Dd          , Dd          , Dd          , Dd          , Dd          , Dd          , Dd          , Dd          , Dd          , Dd          , Hd          , Dd          , Dd          , Dd          , Dd          , Dd          , Rd          , Rd          , Rd          , Rd          , Dd          , Dd          , Dd          , Hd          , Dd          , Dd          , Re          , Dd          , Re^Vct      , Dd          , Dd          , Hd          , Dd          
Dd          , Dd          , Dd          , Dd          , Dd          , Dd          , Dd          , Dd          , Dd          , Dd          , Dd          , Dd          , Dd          , Dd          , Dd          , Dd          , Dd          , Dd          , Dd          , Dd          , Dd          , Dd          , Dd          , Dd          , Dd          , Dd          , Dd          , Dd          , Dd          , Dd          , Dd          , Dd          , Dd          , Dd          , Rd          , Rd          , Rd          , Dd          , Dd          , Dd          , Dd          , Re^Vct      , Dd          , Dd          , Dd          , Dd          , Dd          , Dd          
Dd          , Dd          , Dd          , Dd          , Dd          , Dd          , Dd          , Dd          , Dd          , Dd          , Dd          , Dd          , Dd          , Dd          , Dd          , Dd          , Dd          , Dd          , Dd          , Dd          , Dd          , Dd          , Dd          , Dd          , Dd          , Dd          , Dd          , Dd          , Dd          , Dd          , Dd          , Dd          , Dd          , Dd          , Dd          , Rd          , Rd          , Rd          , Dd          , Dd          , Dd          , Dd          , Dd          , Dd          , Dd          , Dd          , Dd          , Dd          
